R 960 540
NO ./img/stone1.xpm
SO ./img/wall1.xpm
WE ./img/wood.xpm
EA ./img/stone5.xpm

S ./img/barrel.xpm
F ./img/ceil2.xpm
C ./img/ceil.xpm

1111111111111111111111111111
1111111111111111111111111111
11S2218011000000000000000011
1100210068900000000000000011
1184011111111111111111110111
1117114040404105010404040411
1100470404040000004040404011
1111111111111111111111111711
1100000000000000000001909011
1100000000000000000001090911
1100000000000000000001909011
1111111111111111111111111111
1111111111111111111111111111
