R 960 540
NO ./img/stone1.xpm
SO ./img/wall1.xpm
WE ./img/wood.xpm
EA ./img/stone5.xpm

S ./img/barrel.xpm
F ./img/ceil2.xpm
C ./img/ceil.xpm

11111111111111111111111111
11111111111111111111111111
11S22111111111111111111111
11002111111111111111111111
11800600999999999999811111
11111111111111111111711111
11220000000000000000500011
11000000000200000000000011
11000000000000000000000011
11000111100111001000100011
11000100000010001100100011
11000111000010001010100011
11000100000111001001100011
11000000000000000000000011
11002000000000000000000011
11022220000020000220000211
11111111111111111111111111
11111111111111111111111111
