R 960 540
NO ./img/stone1.xpm
SO ./img/wall1.xpm
WE ./img/wood.xpm
EA ./img/stone5.xpm

S ./img/barrel.xpm
F ./img/ceil2.xpm
C ./img/ceil.xpm

11111111111111111111111111
11111111111111111111111111
11S22100020000000000091811
11002100000000000000021011
11000120000000090000001911
11171100900000000000001911
11000000000000200000000911
11171111111111111111111111
11000111111111111111111111
1123211
1111111
1111111
