R 960 540
NO ./img/stone1.xpm
SO ./img/wall1.xpm
WE ./img/wood.xpm
EA ./img/stone5.xpm

S ./img/barrel.xpm
F ./img/ceil2.xpm
C ./img/ceil.xpm

11111111111111111111111111
11111111111111111111111111
11000000000000000000000011
11000000000000000000000011
11000011111100111111000011
11000010000100600881000011
1100001111110011111100001111111111111
110000000000000000000000000000000000011
1100000000000400000020000000000000000011
1100000000000500000E00000000000900000011
110000000000000000000000000000000000011
1100001111110011111100001111111111111
11000010000100700031000011
11000011111100111111000011
11000000000000000000000011
11000000000000000000000011
11111111111111111111111111
11111111111111111111111111
