R 1920 1080
NO ./img/mur.xpm
SO ./img/mur.xpm
WE ./img/mur.xpm
EA ./img/mur.xpm

S ./img/mur.xpm
F 225,100,0
C 225,30,0

11111111111111111111
11000111111111111111
11000111111111111111
11010111111111111111
11000111111111111111
11000111111111111111
11010111111111111111
11000111111111111111
11000100000001000001
11010000100101000011
11000000000001100001
1100010000W000000001
11010100100100000001
11000100000000000001
12000100000000001101
12202100100100111111
12222100000000111111
11111111111111111111
