R 960 540
NO ./img/stone1.xpm
SO ./img/wall1.xpm
WE ./img/wood.xpm
EA ./img/stone5.xpm

S ./img/knight.xpm
F 0,150,40
C 0,40,150

11111111111111111111
11222111111111111111
11222111111111111111
11212111111111111111
11222111111111111111
11222111111111111111
11212111111111111111
11222111111111111111
11222122222221222221
11212222122121222211
11222222222221122221
1122212222W222222221
11212122122122222221
11222122222222222221
12222122222222221121
12222122122122111111
12222122222222111111
11111111111111111111
