R 960 540
NO ./img/stone1.xpm
SO ./img/wall1.xpm
WE ./img/wood.xpm
EA ./img/stone5.xpm

S ./img/barrel.xpm
F 0,150,40
C 0,40,150

11111111111111111111
11000111111111111111
11000111111111111111
11010111111111111111
11000111111111111111
11000111111111111111
11010111111111111111
11000111111111111111
11000100000001000001
11010000100101000011
11000000000001100001
1100010000N000000001
11010100100100000001
11000100000000000001
10000100000000001101
12000100100100111111
10000100000000111111
11111111111111111111
