R 1920 1080
NO ./img/stone1.xpm
SO ./img/wall1.xpm
WE ./img/wood.xpm
EA ./img/stone5.xpm

S img/knight.xpm
F 0,150,40
C 0,40,150

11111111111111111111111111
11111111111111111111111111
11000000000000000000000011
11000000000000000000010011
11000011111100111111000011
11000010000100100001000011
1100001111110011111100001111111111111
110000000000000000000000000000000000011
11000000000000000000E0002000000000000011
110000000000000000000000000000000000011
1100000000000000000000001111111111111
11000011111100111111000011
11000010000100100001000011
11000011111100111111000011
11000000000000000000000001
11000000000000000000000011
11111111111111111111111111
11111111111111111111111111
