R 960 540
NO ./img/stone1.xpm
SO ./img/wall1.xpm
WE ./img/wood.xpm
EA ./img/stone5.xpm

S ./img/knight.xpm
F 0,150,40
C 0,40,150

11111111111111111111
12222222222222222221
12222222222222222221
12222222222222222221
12222222222222222221
12222222222222222221
12222222222222222221
12222222222222222221
1222222222W222222221
12222222222222222221
12222222222222222221
12222222222222222221
12222222222222222221
12222222222222222221
12222222222222222221
12222222222222222221
12222222222222222221
11111111111111111111
